{
  "name": "GMMK Pro",
  "vendorProductId": 839864388,
  "macros": ["", "", "", "", "", "", "", "", "", "", "", "", "", "", "", ""],
  "layers": [
    [
      "KC_LSFT",
      "KC_MUTE",
      "KC_NO",
      "KC_LEFT",
      "KC_RCTL",
      "KC_RGHT",
      "KC_LCTL",
      "KC_F5",
      "KC_Q",
      "KC_TAB",
      "KC_A",
      "KC_ESC",
      "KC_Z",
      "KC_PGUP",
      "KC_GRV",
      "KC_1",
      "KC_W",
      "TT(2)",
      "KC_S",
      "KC_NO",
      "KC_X",
      "KC_PGDN",
      "KC_F1",
      "KC_2",
      "KC_E",
      "KC_F3",
      "KC_D",
      "KC_F4",
      "KC_C",
      "KC_UP",
      "KC_F2",
      "KC_3",
      "KC_R",
      "KC_T",
      "KC_F",
      "KC_G",
      "KC_V",
      "KC_B",
      "KC_5",
      "KC_4",
      "KC_U",
      "KC_Y",
      "KC_J",
      "KC_H",
      "KC_M",
      "KC_N",
      "KC_6",
      "KC_7",
      "KC_I",
      "KC_RBRC",
      "KC_K",
      "KC_F6",
      "KC_COMM",
      "KC_HOME",
      "KC_EQL",
      "KC_8",
      "KC_O",
      "KC_F7",
      "KC_L",
      "KC_DOWN",
      "KC_DOT",
      "KC_END",
      "KC_F8",
      "KC_9",
      "KC_P",
      "KC_LBRC",
      "KC_SCLN",
      "KC_QUOT",
      "KC_NO",
      "KC_SLSH",
      "KC_MINS",
      "KC_0",
      "KC_LGUI",
      "KC_RSFT",
      "MO(1)",
      "KC_LALT",
      "KC_SPC",
      "KC_RALT",
      "KC_NO",
      "KC_DEL",
      "KC_NO",
      "KC_BSPC",
      "KC_BSLS",
      "KC_F11",
      "KC_ENT",
      "KC_F12",
      "KC_F9",
      "KC_F10"
    ],
    [
      "KC_TRNS",
      "KC_TRNS",
      "KC_NO",
      "RGB_SPD",
      "TO(3)",
      "RGB_SPI",
      "KC_TRNS",
      "KC_MPRV",
      "KC_TRNS",
      "KC_TRNS",
      "KC_TRNS",
      "KC_TRNS",
      "KC_TRNS",
      "KC_HOME",
      "KC_TRNS",
      "KC_TRNS",
      "RGB_VAI",
      "KC_CAPS",
      "RGB_VAD",
      "KC_NO",
      "RGB_HUI",
      "KC_END",
      "KC_MYCM",
      "KC_TRNS",
      "KC_TRNS",
      "KC_CALC",
      "KC_TRNS",
      "KC_MSEL",
      "KC_TRNS",
      "RGB_MOD",
      "KC_WWW_HOME",
      "KC_TRNS",
      "KC_TRNS",
      "KC_TRNS",
      "KC_TRNS",
      "KC_TRNS",
      "KC_TRNS",
      "KC_TRNS",
      "KC_TRNS",
      "KC_TRNS",
      "KC_PSCR",
      "KC_TRNS",
      "KC_TRNS",
      "KC_TRNS",
      "KC_TRNS",
      "KC_NLCK",
      "KC_TRNS",
      "KC_TRNS",
      "KC_SLCK",
      "KC_TRNS",
      "KC_TRNS",
      "KC_MNXT",
      "KC_NO",
      "RGB_TOG",
      "KC_TRNS",
      "KC_TRNS",
      "KC_PAUS",
      "KC_MPLY",
      "KC_TRNS",
      "RGB_RMOD",
      "KC_NO",
      "KC_TRNS",
      "KC_MSTP",
      "KC_TRNS",
      "KC_TRNS",
      "KC_TRNS",
      "KC_TRNS",
      "KC_TRNS",
      "KC_NO",
      "KC_F14",
      "KC_TRNS",
      "KC_TRNS",
      "KC_NO",
      "KC_F13",
      "KC_TRNS",
      "KC_TRNS",
      "KC_TRNS",
      "KC_CAPS",
      "KC_NO",
      "KC_CALC",
      "KC_NO",
      "KC_TRNS",
      "RESET",
      "KC_VOLU",
      "KC_TRNS",
      "KC_TRNS",
      "KC_MUTE",
      "KC_VOLD"
    ],
    [
      "KC_TRNS",
      "KC_TRNS",
      "KC_NO",
      "C(RCTL(KC_LEFT))",
      "KC_TRNS",
      "C(RCTL(KC_RGHT))",
      "KC_TRNS",
      "KC_TRNS",
      "KC_HOME",
      "KC_TRNS",
      "KC_LEFT",
      "KC_TRNS",
      "KC_CAPS",
      "KC_HOME",
      "C(S(KC_M))",
      "C(S(KC_B))",
      "KC_UP",
      "TO(0)",
      "KC_DOWN",
      "KC_NO",
      "KC_DEL",
      "KC_END",
      "KC_TRNS",
      "KC_TRNS",
      "KC_END",
      "KC_TRNS",
      "KC_RGHT",
      "KC_TRNS",
      "KC_INS",
      "C(RCTL(KC_PGUP))",
      "KC_TRNS",
      "KC_TRNS",
      "KC_PGUP",
      "KC_TRNS",
      "KC_PGDN",
      "KC_TRNS",
      "KC_NO",
      "KC_NO",
      "KC_TRNS",
      "KC_TRNS",
      "KC_P4",
      "KC_TAB",
      "KC_P1",
      "KC_TRNS",
      "KC_P0",
      "KC_NO",
      "KC_TRNS",
      "KC_P7",
      "KC_P5",
      "KC_TRNS",
      "KC_P2",
      "KC_TRNS",
      "KC_NO",
      "KC_TRNS",
      "KC_PPLS",
      "KC_P8",
      "KC_P6",
      "KC_TRNS",
      "KC_P3",
      "C(RCTL(KC_PGDN))",
      "KC_PDOT",
      "KC_TRNS",
      "KC_TRNS",
      "KC_P9",
      "KC_PPLS",
      "KC_TRNS",
      "KC_PENT",
      "KC_PAST",
      "KC_NO",
      "KC_PSLS",
      "KC_PMNS",
      "KC_P0",
      "KC_TRNS",
      "KC_TRNS",
      "KC_TRNS",
      "KC_TRNS",
      "KC_BSPC",
      "KC_TRNS",
      "KC_NO",
      "KC_TRNS",
      "KC_NO",
      "KC_TRNS",
      "KC_TRNS",
      "KC_TRNS",
      "KC_PENT",
      "KC_TRNS",
      "KC_TRNS",
      "KC_TRNS"
    ],
    [
      "KC_TRNS",
      "KC_TRNS",
      "KC_NO",
      "KC_TRNS",
      "KC_TRNS",
      "KC_TRNS",
      "KC_TRNS",
      "KC_TRNS",
      "KC_TRNS",
      "KC_TRNS",
      "KC_TRNS",
      "KC_TRNS",
      "KC_TRNS",
      "KC_TRNS",
      "KC_TRNS",
      "KC_TRNS",
      "KC_TRNS",
      "KC_F22",
      "KC_TRNS",
      "KC_NO",
      "KC_TRNS",
      "KC_TRNS",
      "KC_TRNS",
      "KC_TRNS",
      "KC_TRNS",
      "KC_TRNS",
      "KC_TRNS",
      "KC_TRNS",
      "KC_TRNS",
      "KC_TRNS",
      "KC_TRNS",
      "KC_TRNS",
      "KC_TRNS",
      "KC_TRNS",
      "KC_TRNS",
      "KC_TRNS",
      "KC_TRNS",
      "KC_TRNS",
      "KC_TRNS",
      "KC_TRNS",
      "KC_TRNS",
      "KC_TRNS",
      "KC_TRNS",
      "KC_TRNS",
      "KC_TRNS",
      "KC_TRNS",
      "KC_TRNS",
      "KC_TRNS",
      "KC_TRNS",
      "KC_TRNS",
      "KC_TRNS",
      "KC_TRNS",
      "KC_TRNS",
      "KC_TRNS",
      "KC_TRNS",
      "KC_TRNS",
      "KC_TRNS",
      "KC_TRNS",
      "KC_TRNS",
      "KC_TRNS",
      "KC_TRNS",
      "KC_TRNS",
      "KC_TRNS",
      "KC_TRNS",
      "KC_TRNS",
      "KC_TRNS",
      "KC_TRNS",
      "KC_TRNS",
      "KC_NO",
      "KC_TRNS",
      "KC_TRNS",
      "KC_TRNS",
      "KC_TRNS",
      "KC_TRNS",
      "TO(0)",
      "KC_TRNS",
      "KC_TRNS",
      "KC_TRNS",
      "KC_NO",
      "KC_TRNS",
      "KC_NO",
      "KC_TRNS",
      "KC_TRNS",
      "KC_TRNS",
      "KC_TRNS",
      "KC_TRNS",
      "KC_TRNS",
      "KC_TRNS"
    ]
  ]
}